Width: 40
Height: 30
TileSize: 32
0000000000000000000000000000000000000000
0000100000000010000000001000000000100000
0230000010023000001002300000100230000010
0450000000045000000004500000000450000000
0000010230000001023000000102300000010230
0000000450000000045000000004500000000450
0002300000000230000000023000000002300000
0104502300010450230001045023000104502300
0000004500000000450000000045000000004500
0000000000000000000000000000000000000000
0000000000000000000000000000000000000000
0000100000000010000000001000000000100000
0230000010023000001002300000100230000010
0450000000045000000004500000000450000000
0000010230000001023000000102300000010230
0000000450000000045000000004500000000450
0002300000000230000000023000000002300000
0104502300010450230001045023000104502300
0000004500000000450000000045000000004500
0000000000000000000000000000000000000000
0002300000000230000000023000000002300000
0104502300010450230001045023000104502300
0000004500000000450000000045000000004500
0000000000000000000000000000000000000000
0002300000000230000000023000000002300000
0104502300010450230001045023000104502300
0000004500000000450000000045000000004500
0000000000000000000000000000000000000000
0000000000000000000000000000000000000000
0000000000000000000000000000000000000000